################
#..............#
#..............#
#..............#
#..............#
#......M.......#
#..............#
#..............#
#..............#
#.............I#
################