############
#..........#
#..........#
#..........#
#....E.....#
#..........#
#..........#
#..........#
#..........#
#..........#
#..........#
############